############################################
#    .      #     .  #                     #
#       #   .  #     #      #              #
#       #      #     #      #              #
#  .    ########  .  #      #              #
#       #                   #              #
#       #       ##################         #
#       #       #                          #
#    ####       #                          #
#               #         ##################
#    ############                          #
#                        #                 #
#       #############    #                 #
#                        #                 #
############################################